____________________
____________________
__WW________________
__WW________________
__WW____d______g____
__WW____e______e____
__WW____e______e____
________e______e____
________faaaaaac____
____________________
__WW________________
__WW________________
__WW________________
__WW________________
__WW________________
__WW________________
__WW________________
__WW________________
____________________
____________________