____________________
____________________
__WW________________
__WW____________g___
__WW____g______dfa__
__WW____e______b____
__W_____e______b____
________e______b____
________faaaaaac____
____________________
__W_________________
__WW________________
__WW________________
__WW________________
__WW________________
__WW________________
__WW________________
__WW________________
____________________
____________________