____________________
____________________
____0_______________
____0_______________
____0_______________
____0_______________
___8@_______________
__8@________________
__0_________________
__!3________________
___!3_______________
____0_______________
____0_______________
____0_______________
____0_______________
____0_______________
____0_______________
____0_______________
____________________
____________________