____________________
____________________
____0_______________
____0_______________
____0_______________
____0_______________
____0_______________
__87@_______________
__0________________
__!13_______________
____0_______________
____0_______________
____0_______________
____0_______________
____0_______________
____0_______________
____0_______________
____0_______________
____________________
____________________