_____________
_____________
__40_________
__2!3________
__5!!1113____
__487777@____
__40_________
__40_________
__40_________
__40______6__
__4!1111112__
_____________
_____________