_____________
_-----------_
_--________-_
_----______-_
_--------__-_
_--------__-_
_---_______-_
_---_______-_
_---_______-_
_---______--_
_-----------_
_-----------_
_____________